6 6
S . . . . .
. . . . . .
. . . . . .
. . . . . .
. . . . . .
. . . . . G
