16 32
S . . . . . 2 . . . . . . . . . . . . . . . . . . . . . . . . .
. . . . # . . . . . . . . . . 3 . . . . . . . . . . . . . . . .
. . # . . . . . . . . 2 . . . . . . . # . . . . . . . . . . . .
. . . . . . . . . # . . . . . . . . . # . . . . . . . . . . . .
. . . . . . . . . . . . . # . . . . . . . . . . . . 2 . . . . .
. . . . . . . 2 . . . . . . . . . . . . . # . . . . . . . . . .
. . . . . . . . . . . . . . . . . . . . . . . . . . . . . . . .
9 9 9 9 9 9 9 9 9 9 9 9 9 9 9 9 9 9 9 9 9 9 9 9 9 9 9 9 9 9 9 .
# # # # # # # # # # # # # # # # # # # # # # # # # # # # # # # .
. . . . . . . . . . . . . . . . . . . . . . . . . . . . . . . .
. . . . . . . 2 . . . . . . . . . . . # . . . . . . . . . . . .
. . . . . . . . . . . # . . . . . 3 . . . . . . . . . . . . . .
. . # . . . . . . . . . . . . . . . . . . . . # . . . . . . . .
. . . . . . . . . . . . . . . . . . . . . . . . . . . . 2 . . .
. . . . . 2 . . . . . . . # . . . . . . . . . . . . . . . . . .
. . . . . . . . . . . . . . . . . . . . . . . . . . . . . . . G
